11111111111111111111111111111111111111111111111111111111
10000000C00000100001000000000000000000C000000011000000E1
100P00001001000000000000000C0001000000000000000000C00001
1111111111111111111111111111111111111111111111111111111C