1111111111111111111111111111111111111111111111111111111E
10000000C00000000001000000000000000000C00000001100000001
100P00001001001000000000000C0001000000000000000000C00001
11111111111111111111111111111111111111111111111111111111