11111111111111111111111111111111111111111111111111111111
1111111E111111111111111C11111P11111111111111111111111111
11111111111111111111111111111111111111111111111111111111