11111111111111111111111111111111111111111111111111111111
100000001000000000010000000000000000000000000011000000E1
100P0000100100100000000000000001000000000000000000C00001
11111111111111111111111111111111111111111111111111111111