11111111
1001000011111
10000111111
1P0011E00001
1111111111111