111111111
10C101C01
101101101
1000P0001
1C1101101
10E101C01
111111111
