111111111111111111111111111111111111
11E0000000000000C00000C0000000000011
110100101001000001010010000000101011
110100100101010100010010000000101011
11C0000000C00C0000000000000000000C11
110000000CCC000000011110000001011111
11000000011110000001111000000CC00011
111111111111111111111111111111111111
111111111111111111111111111111111111