111111111111111111111111111111111111
11E000000000000000000000000000000011
110100101001000001010010000000101011
110100100101010100010010000000101011
11P000000000000000000000000000000011
110000000000000000011110000001011111
110000000111100000011110000000000011
111111111111111111111111111111111111
111111111111111111111111111111111111