11111111111111111111111111111111111111111111111111111111
10000000100000100001000000000000000000000000000000000001
100E0000100100100000000000000000000000000000000000C00001
10000000100100000001000000000000000000000000000000000001
1111011111111111111100000000C000000000000000000000000001
10000000000000000000000000000000000000000000000000000001
10000000000000C000000000000000000000000000C0000000000001
10000000000000000000000000000000000000000000000000000001
1000000000000000000000000C000000000000000000000000C00001
10000000000000000000000000000000000000000000000000000001
10000C00000000000000000000111000000000000C00000000000001
100000000000000000000000001P1000000000000000000000000001
10000000000000000000000000101000000000000000C00000000001
100000000C0000000000000000000000000000000000000000000001
10000000000000000000000000000000000000000000000000000001
10000000000000C00000000000000000000000000000000C00000001
1000000000000000000000000C000000000000000000000000000001
10000000000000000000000000000000000000000000000000000001
10000000000000000000000000000000000000000000000000000001
11111111111111111111111111111111111111111111111111111111